$$$$$$$$$$$$$$$
$***#*****#***$
$*#*###*#*#*#*$
$*#*#***#*#*#*$
$*#*#*###*#*#*$
$*#***#*#*#*#*$
$*###*#*#*#*#*$
$*#***#*****#*$
$*###*#*###*#*$
$*#*#*#*#*#*#*$
$*#*#####*###*$
$***#*#*****#*$
$*###*#####*#*$
$*****#*******$
$$$$$$$$$$$$$$$
