$$$$$$$$$$$$$$$$$$$$$$$
$*****#***#***#***#***$
$*#*###*#*#*#*#*#*#*#*$
$*#*****#***#***#*#*#*$
$*#####*#########*#*#*$
$***#*#*#*****#H#***#*$
$##*#*###*###*#*#####*$
$*****#*#*#*****#***#*$
$*#####*#*###*###*#*#*$
$***#P**#***#***#*#***$
$##*###*###*###*###*##$
$*#***#*****#*********$
$*#*#####*#########*#*$
$***#***#*#*****#***#*$
$*###*#*###*###*#*###*$
$*****#**H#***#***#***$
$$$$$$$$$$$$$$$$$$$$$$$
