$$$$$$$$$$$$$$$
$***#*****#***$
$*#*#####*#*#*$
$*#*#***#*#*#*$
$*#*#*###*#*#*$
$*#*****#*#*#*$
$*###*#*#*#*#*$
$*#***#*****#*$
$*###*#*###*#*$
$*#*#*#*#*#*#*$
$*#*#####*###*$
$***#*#*****#*$
$*###*#####*#*$
$*****#*******$
$$$$$$$$$$$$$$$
