$$$$$$$$$$$$$$$$$$$$$$$$$
$*#*#*****#*************$
$*#*#*###*###*#####*###*$
$***#***#*****#***#*#***$
$*#*###*#######*#*#*#*##$
$*#*#*****#H#EEE#***#***$
$*###*###*#*###*########$
$***#*#***#**E**#*******$
$##*###*#####E#####*###*$
$*******#****E#*#***#EEE$
$##########*###*#*#####*$
$*****#***#*#*******#***$
$##*#*#*#*#*#*#####*#*##$
$***#***#***#***#H**#EEE$
$*#*###########*#####*##$
$*#*#E**#***#*****#*#***$
$*###E###*#*#*#*#*#*###*$
$****E****#***#*#***#P**$
$$$$$$$$$$$$$$$$$$$$$$$$$
