$$$$$$$$$$$$$$$$$$$$$
$*****#*****#****E**$
$####*#*###*#*###E##$
$***#*#*#E**#*#**E**$
$*#*#*###E#####*###*$
$*#H#*#**E**#*****#*$
$*###*###E#*#*#####*$
$*#******E#***#*****$
$*#############*####$
$*********#**H#*#***$
$*#####*###*###*#*#*$
$*****#***#**E#*#*#*$
$####*###*###E#*#*#*$
$*****#***#**E#***#*$
$*###*#*###*#E#####*$
$**P#*#*****#E******$
$$$$$$$$$$$$$$$$$$$$$
