$$$$$$$$$$$$$$$$$$$
$*********#******H$
$*#######*#*######$
$*******#*#*#EEEEE$
$######*#*#*###*#*$
$****E#*#*****#*#*$
$*###E#*#####*#*#*$
$*#**E**#***#***#*$
$##*#####*#*#####*$
$***#*****#***#EEE$
$##*#*#######*###*$
$***#***#P******#*$
$*#####*#########*$
$****H#***********$
$$$$$$$$$$$$$$$$$$$
