$$$$$$$$$$$$$$$$$$$$$$$$$
$*****#***#***#*****#***$
$*#*###*#*#*#*#*###*#*#*$
$*#*****#***#***#*#*#*#*$
$*#####*#########*#*#*#*$
$***#*#*#*****#*#*****#*$
$##*#*###*###*#*#######*$
$*****#*#*#*****#*****#*$
$*#####*#*###*###*###*#*$
$***#P**#***#***#H#*#***$
$##*###*###*###*###*####$
$*#***#*****#*******#***$
$*#*###*#*#########*#*##$
$***#***#*#*****#*******$
$*#*#######*###*#######*$
$*#*#*****#*#*****#***#*$
$*###*###*#*#*###*#*#*#*$
$*****#*****#**H#***#***$
$$$$$$$$$$$$$$$$$$$$$$$$$