$$$$$$$$$$$$$$$$$$$$$$$$$
$*#*#*****#*************$
$*#*#*###*###*#####*###*$
$***#***#*****#***#*#***$
$*#*###*#######*#*#*#*##$
$*#*#*****#H#***#***#***$
$*###*###*#*###*########$
$***#*#***#*****#*******$
$##*###*#####*#####*###*$
$*******#*****#*#***#***$
$##########*###*#*#####*$
$*****#***#*#*******#***$
$##*#*#*#*#*#*#####*#*##$
$***#***#***#***#H**#***$
$*#*###########*#####*##$
$*#*#***#***#*****#*#***$
$*###*###*#*#*#*#*#*###*$
$*********#***#*#***#P**$
$$$$$$$$$$$$$$$$$$$$$$$$$
