$$$$$$$$$$$$$$$
$***#**P**#***$
$***#*****#***$
$*#***#*#*#*#*$
$*#####*#*###*$
$*#***#*#*****$
$##*#*#*#*#*##$
$***#*#*#*#***$
$##*#*#*###*##$
$H#*#*#***#***$
$*#*#####*###*$
$*#*#*******#*$
$*****#######*$
$*****#H******$
$$$$$$$$$$$$$$$
