$$$$$$$$$$$$$$$$$$$$$$$$$$$
$*#***#*****#*************$
$*#*#*#*###*#####*#######*$
$***#*#***#*****#*#*****#*$
$####*#*#######*###*###*#*$
$*****#***#***#*****#H#***$
$*#######*###*#######*###*$
$*#*****#****P**#*****#***$
$*#*###*#####*#####*###*##$
$***#*#*#***#*#*****#***#*$
$*###*#*###*###*#####*###*$
$***#*****#*****#*******#*$
$##*#*#######*###*#######*$
$***#*********#*******#***$
$*#############*#######*##$
$***#*******#***********#H$
$*#*#*#####*#*#####*#####*$
$*#***#***#*******#*#***#*$
$*#####*#*#######*###*#*#*$
$*******#*******#*****#***$
$$$$$$$$$$$$$$$$$$$$$$$$$$$

