$$$$$$$$$$$$$$$$$$$$$$$$$$$$$
$*******#***#*********#*#***$
$*#####*#*#*###*###*###*###*$
$*#***#*#*#***#***#*****#***$
$*#*#*#*#####*###*#####*#*#*$
$***#*#***#*******#H**#***#*$
$##*#*#########*#*###*###*##$
$***#*****#***#*#*****#*#***$
$*#######*###*#####*###*#*#*$
$*****#*********#***#*****#*$
$##############*#*#####*###*$
$*****#***#***#*#*#*#*****#H$
$##*#*#*#*#*#*#*#*#*#*#*####$
$***#***#***#***#***#*#*#***$
$*###*#########*#*#*#*###*#*$
$*#*#*#*****#***#*#*#*****#*$
$*#*#####*#########*#######*$
$*****#*#***#*******#***#***$
$*#*###*#*#*#*#######*#*#*##$
$*#***#***#*#***#***#*#***#*$
$##*#*#*###*#*###*#*#*###*#*$
$***#*****#***#P**#***#*****$
$$$$$$$$$$$$$$$$$$$$$$$$$$$$$
