$$$$$$$$$$$$$$$
$***#*****#***$
$***#*****#***$
$*#***#*#*#*#*$
$*#####*#*###*$
$*#***#*#*****$
$##*#*#*#*#*##$
$***#*#*#*#***$
$##*#*#*###*##$
$*#*#*#***#***$
$*#*#####*###*$
$*#*#*******#*$
$*****#######*$
$*****#*******$
$$$$$$$$$$$$$$$
