$$$$$$$$$$$$$$$
$***#*****#***$
$*#*#*#*#*#*#*$
$*#***#*#*#*#*$
$*#####*#*###*$
$*#***#*#*****$
$##*#*#*#*#*##$
$***#*#*#*#***$
$##*#*#*###*##$
$H#*#P#***#***$
$*#*#####*###*$
$*#*#*******#*$
$*#*#*#######*$
$*****#H******$
$$$$$$$$$$$$$$$

