$$$$$$$$$$$$$$$$$$$
$*********#******H$
$*#######*#*######$
$*******#*#*#*****$
$######*#*#*###*#*$
$*****#*#*****#*#*$
$*###*#*#####*#*#*$
$*#*****#***#***#*$
$##*#####*#*#####*$
$***#*****#***#***$
$##*#*#######*###*$
$***#***#P******#*$
$*#####*#########*$
$****H#***********$
$$$$$$$$$$$$$$$$$$$
