$$$$$$$$$$$$$$$$$$$$$
$*****#*****#*******$
$####*#*###*#*###*##$
$***#*#*#***#*#*****$
$*#*#*###*#####*###*$
$*#H#*#*****#*****#*$
$*###*###*#*#*#####*$
$*#*******#***#*****$
$*#############*####$
$*********#**H#*#***$
$*#####*###*###*#*#*$
$*****#***#***#*#*#*$
$####*###*###*#*#*#*$
$*****#***#***#***#*$
$*###*#*###*#*#####*$
$**P#*#*****#*******$
$$$$$$$$$$$$$$$$$$$$$
