$$$$$$$$$$$$$$$$$$$$$$$$$
$*****#***#***#*****#***$
$*#*###*#*#*#*#*###*#*#*$
$*#*****#***#***#*#*#*#*$
$*#####*#########*#*#*#*$
$***#*#*#*****#*#EEEEE#*$
$##*#*###*###*#*#######*$
$*****#*#*#EEEEE#*****#*$
$*#####*#*###*###*###*#*$
$**E#P**#***#***#H#*#***$
$##E###*###*###*###*####$
$*#E**#**E**#*******#E**$
$*#E###*#E#########*#E##$
$**E#***#E#*****#****E**$
$*#E#######*###*#######*$
$*#E#*****#*#*****#***#*$
$*###*###*#*#*###*#*#*#*$
$*****#*****#**H#***#***$
$$$$$$$$$$$$$$$$$$$$$$$$$

